1 2 5 0 0 0 0 0 0
2 1 5 3 5 0 0 0 0
3 2 5 6 5 7 5 11 5
4 5 5 0 0 0 0 0 0
5 4 5 7 2 0 0 0 0
6 3 7 11 5 12 5 0 0
7 3 5 5 2 8 7 11 5
8 7 7 9 5 10 3 11 5
9 8 5 10 1 12 5 0 0
10 8 3 9 1 12 5 0 0
11 3 5 6 5 7 5 8 5
12 6 5 9 5 10 5 0 0