1 2 5 0 0 0 0 0 0
2 1 5 3 5 0 0 0 0
3 2 5 4 5 0 0 0 0
4 3 5 5 3 8 5 9 5
5 4 3 9 7 11 3 13 5
8 4 5 0 0 0 0 0 0
9 4 5 5 7 0 0 0 0
11 5 3 0 0 0 0 0 0
12 13 3 0 0 0 0 0 0
13 5 5 12 3 14 3 15 3
14 13 3 0 0 0 0 0 0
15 13 3 0 0 0 0 0 0
