1 2 3 0 0 0 0 0 0
2 1 3 4 7 6 7 8 3
4 2 7 0 0 0 0 0 0
6 2 7 7 3 8 5 0 0
7 6 3 0 0 0 0 0 0
8 2 3 6 5 0 0 0 0
